GGGGGGGGGGGGGGGGGGGGGGGGGGGGGG
GGTGGGGGGGGGGGGGGGGGGGGGGGGGGG
GGGGGGGGGGGGGGGGGGGGGGGGGGGGGG
GGGGGGGGGGGGGGGGSSGGGGGGGGGGGG
GGGGGGGGGGGGGGGSSSSGGGGGGGGGGG
GGGGGGGGGGGGGSSSSSSSGGGGGGGGGG
GGGGGGGGGGGGSSSSSSSSSSGGGGGGGG
GGGGGGGGGGGGGSSSSSSSSGGGGGGGGG
GGGGGGGGGGGGGGSSSSSGGGGGGGGGGG
GGGGGGGGGGGGGGGGSSGGGGGGGGGGGG
GGGGGGGGGGGGGGGGGGGGGGGGGGGGGG
GGGGSSSSSSSSGGGGGGGGGGGGGGGGGG
GGGGGGSSSSGGGGGGGGGGGGGGGGGGGG
GGGGGGGGGGGGGGGGGGGGGGGGGGGGGG
GGGGGGGGGGGGGGGGGGGGGGGGGGGGGG
GGGGGGGGGGGGGGGGGGGGGGGGGGGGGG
GGGGGGGGGGGGGGGGGGGGGGGGGGGEGG
GGGGGGGGGGGGGGGGGGGGGGGGGGGGGG